75 29
start:
#80#80#80#80#80#80#80#80#80#80#80#80#80#80#80#80#80#80#80#80#80#80#80#80#80#80#80#80#80#80#80#80#80#80#80#80#80#80#80#80#80#80#80#80#80#80#80#80#80#80#80#80#80#80#80#80#80#80#80#80#80#80#80#80#80#80#80#80#80#80#80#80#80#80#80
#80#88#80#88#80#88#80#88#80#88#80#88#80#88#80#88#80#88#80#88#80#88#80#88#80#88#80#88#80#88#80#88#80#88#80#88#80#88#80#88#80#88#80#88#80#88#80#88#80#88#80#88#80#88#80#88#80#88#80#88#80#88#80#88#80#88#80#88#80#88#80#88#80#88#80
#80#80#80#80#80#80#80#80#80#80#80#80#80#80#80#80#80#80#80#80#80#80#80#80#80#80#80#80#80#80#80#80#80#80#80#80#80#80#80#80#80#80#80#80#80#80#80#80#80#80#80#80#80#80#80#80#80#80#80#80#80#80#80#80#80#80#80#80#80#80#80#80#80#80#80
#80#88#80#88#80#88#80#88#80#88#80#88#80#88#80#88#80#88#80#88#80#88#80#88#80#88#80#88#80#88#80#88#80#88#80#88#80#88#80#88#80#88#80#88#80#88#80#88#80#88#80#88#80#88#80#88#80#88#80#88#80#88#80#88#80#88#80#88#80#88#80#88#80#88#80
#80#80#80#80#80#80#80#80#80#80#80#80#80#80#80#80#80#80#80#80#80#80#80#80#80#80#80#80#80#80#80#80#80#80#80#80#80#80#80#80#80#80#80#80#80#80#80#80#80#80#80#80#80#80#80#80#80#80#80#80#80#80#80#80#80#80#80#80#80#80#80#80#80#80#80
#80#88#80#88#80#88#80#88#80#88#80#88#80#88#80#88#80#88#80#88#80#88#80#88#80#88#80#88#80#88#80#88#80#88#80#88#80#88#80#88#80#88#80#88#80#88#80#88#80#88#80#88#80#88#80#88#80#88#80#88#80#88#80#88#80#88#80#88#80#88#80#88#80#88#80
#80#80#80#80#80#80#80#80#80#80#80#80#80#80#80#80#80#80#80#80#80#80#80#80#80#80#80#80#80#80#80#80#80#80#80#80#80#80#80#80#80#80#80#80#80#80#80#80#80#80#80#80#80#80#80#80#80#80#80#80#80#80#80#80#80#80#80#80#80#80#80#80#80#80#80
#80#88#80#88#80#88#80#88#80#88#80#88#80#88#80#88#80#88#80#88#80#88#80#88#80#88#80#88#80#88#80#88#80#88#80#88#80#88#80#88#80#88#80#88#80#88#80#88#80#88#80#88#80#88#80#88#80#88#80#88#80#88#80#88#80#88#80#88#80#88#80#88#80#88#80
#80#80#80#80#80#80#80#80#80#80#80#80#80#80#80#80#80#80#80#80#80#80#80#80#80#80#80#80#80#80#80#80#80#80#80#80#80#80#80#80#80#80#80#80#80#80#80#80#80#80#80#80#80#80#80#80#80#80#80#80#80#80#80#80#80#80#80#80#80#80#80#80#80#80#80
#80#88#80#88#80#88#80#88#80#88#80#88#80#88#80#88#80#88#80#88#80#88#80#88#80#88#80#88#80#88#80#88#80#88#80#88#80#88#80#88#80#88#80#88#80#88#80#88#80#88#80#88#80#88#80#88#80#88#80#88#80#88#80#88#80#88#80#88#80#88#80#88#80#88#80
#80#80#80#80#80#80#80#80#80#80#80#80#80#80#80#80#80#80#80#80#80#80#80#80#80#80#80#80#80#80#80#80#80#80#80#80#80#80#80#80#80#80#80#80#80#80#80#80#80#80#80#80#80#80#80#80#80#80#80#80#80#80#80#80#80#80#80#80#80#80#80#80#80#80#80
#80#88#80#88#80#88#80#88#80#88#80#88#80#88#80#88#80#88#80#88#80#88#80#88#80#88#80#88#80#88#80#88#80#88#80#88#80#88#80#88#80#88#80#88#80#88#80#88#80#88#80#88#80#88#80#88#80#88#80#88#80#88#80#88#80#88#80#88#80#88#80#88#80#88#80
#80#80#80#80#80#80#80#80#80#80#80#80#80#80#80#80#80#80#80#80#80#80#80#80#80#80#80#80#80#80#80#80#80#80#80#80#80#80#80#80#80#80#80#80#80#80#80#80#80#80#80#80#80#80#80#80#80#80#80#80#80#80#80#80#80#80#80#80#80#80#80#80#80#80#80
#80#88#80#88#80#88#80#88#80#88#80#88#80#88#80#88#80#88#80#88#80#88#80#88#80#88#80#88#80#88#80#88#80#88#80#88#80#88#80#88#80#88#80#88#80#88#80#88#80#88#80#88#80#88#80#88#80#88#80#88#80#88#80#88#80#88#80#88#80#88#80#88#80#88#80
#80#80#80#80#80#80#80#80#80#80#80#80#80#80#80#80#80#80#80#80#80#80#80#80#80#80#80#80#80#80#80#80#80#80#80#80#80#80#80#80#80#80#80#80#80#80#80#80#80#80#80#80#80#80#80#80#80#80#80#80#80#80#80#80#80#80#80#80#80#80#80#80#80#80#80
#80#88#80#88#80#88#80#88#80#88#80#88#80#88#80#88#80#88#80#88#80#88#80#88#80#88#80#88#80#88#80#88#80#88#80#88#80#88#80#88#80#88#80#88#80#88#80#88#80#88#80#88#80#88#80#88#80#88#80#88#80#88#80#88#80#88#80#88#80#88#80#88#80#88#80
#80#80#80#80#80#80#80#80#80#80#80#80#80#80#80#80#80#80#80#80#80#80#80#80#80#80#80#80#80#80#80#80#80#80#80#80#80#80#80#80#80#80#80#80#80#80#80#80#80#80#80#80#80#80#80#80#80#80#80#80#80#80#80#80#80#80#80#80#80#80#80#80#80#80#80
#80#88#80#88#80#88#80#88#80#88#80#88#80#88#80#88#80#88#80#88#80#88#80#88#80#88#80#88#80#88#80#88#80#88#80#88#80#88#80#88#80#88#80#88#80#88#80#88#80#88#80#88#80#88#80#88#80#88#80#88#80#88#80#88#80#88#80#88#80#88#80#88#80#88#80
#80#80#80#80#80#80#80#80#80#80#80#80#80#80#80#80#80#80#80#80#80#80#80#80#80#80#80#80#80#80#80#80#80#80#80#80#80#80#80#80#80#80#80#80#80#80#80#80#80#80#80#80#80#80#80#80#80#80#80#80#80#80#80#80#80#80#80#80#80#80#80#80#80#80#80
#80#88#80#88#80#88#80#88#80#88#80#88#80#88#80#88#80#88#80#88#80#88#80#88#80#88#80#88#80#88#80#88#80#88#80#88#80#88#80#88#80#88#80#88#80#88#80#88#80#88#80#88#80#88#80#88#80#88#80#88#80#88#80#88#80#88#80#88#80#88#80#88#80#88#80
#80#80#80#80#80#80#80#80#80#80#80#80#80#80#80#80#80#80#80#80#80#80#80#80#80#80#80#80#80#80#80#80#80#80#80#80#80#80#80#80#80#80#80#80#80#80#80#80#80#80#80#80#80#80#80#80#80#80#80#80#80#80#80#80#80#80#80#80#80#80#80#80#80#80#80
#80#88#80#88#80#88#80#88#80#88#80#88#80#88#80#88#80#88#80#88#80#88#80#88#80#88#80#88#80#88#80#88#80#88#80#88#80#88#80#88#80#88#80#88#80#88#80#88#80#88#80#88#80#88#80#88#80#88#80#88#80#88#80#88#80#88#80#88#80#88#80#88#80#88#80
#80#80#80#80#80#80#80#80#80#80#80#80#80#80#80#80#80#80#80#80#80#80#80#80#80#80#80#80#80#80#80#80#80#80#80#80#80#80#80#80#80#80#80#80#80#80#80#80#80#80#80#80#80#80#80#80#80#80#80#80#80#80#80#80#80#80#80#80#80#80#80#80#80#80#80
#80#88#80#88#80#88#80#88#80#88#80#88#80#88#80#88#80#88#80#88#80#88#80#88#80#88#80#88#80#88#80#88#80#88#80#88#80#88#80#88#80#88#80#88#80#88#80#88#80#88#80#88#80#88#80#88#80#88#80#88#80#88#80#88#80#88#80#88#80#88#80#88#80#88#80
#80#80#80#80#80#80#80#80#80#80#80#80#80#80#80#80#80#80#80#80#80#80#80#80#80#80#80#80#80#80#80#80#80#80#80#80#80#80#80#80#80#80#80#80#80#80#80#80#80#80#80#80#80#80#80#80#80#80#80#80#80#80#80#80#80#80#80#80#80#80#80#80#80#80#80
#80#88#80#88#80#88#80#88#80#88#80#88#80#88#80#88#80#88#80#88#80#88#80#88#80#88#80#88#80#88#80#88#80#88#80#88#80#88#80#88#80#88#80#88#80#88#80#88#80#88#80#88#80#88#80#88#80#88#80#88#80#88#80#88#80#88#80#88#80#88#80#88#80#88#80
#80#80#80#80#80#80#80#80#80#80#80#80#80#80#80#80#80#80#80#80#80#80#80#80#80#80#80#80#80#80#80#80#80#80#80#80#80#80#80#80#80#80#80#80#80#80#80#80#80#80#80#80#80#80#80#80#80#80#80#80#80#80#80#80#80#80#80#80#80#80#80#80#80#80#80
#80#88#80#88#80#88#80#88#80#88#80#88#80#88#80#88#80#88#80#88#80#88#80#88#80#88#80#88#80#88#80#88#80#88#80#88#80#88#80#88#80#88#80#88#80#88#80#88#80#88#80#88#80#88#80#88#80#88#80#88#80#88#80#88#80#88#80#88#80#88#80#88#80#88#80
#80#80#80#80#80#80#80#80#80#80#80#80#80#80#80#80#80#80#80#80#80#80#80#80#80#80#80#80#80#80#80#80#80#80#80#80#80#80#80#80#80#80#80#80#80#80#80#80#80#80#80#80#80#80#80#80#80#80#80#80#80#80#80#80#80#80#80#80#80#80#80#80#80#80#80
broken:
#0A#0A#0A#0A#0A#0A#0A#0A#0A#0A#0A#0A#0A#0A#0A#0A#0A#0A#0A#0A#0A#0A#0A#0A#0A#0A#0A#0A#0A#0A#0A#0A#0A#0A#0A#0A#0A#0A#0A#0A#0A#0A#0A#0A#0A#0A#0A#0A#0A#0A#0A#0A#0A#0A#0A#0A#0A#0A#0A#0A#0A#0A#0A#0A#0A#0A#0A#0A#0A#0A#0A#0A#0A#0A#0A
#0A#88#0A#88#0A#88#0A#88#0A#88#0A#88#0A#88#0A#88#0A#88#0A#88#0A#88#0A#88#0A#88#0A#88#0A#88#0A#88#0A#88#0A#88#0A#88#0A#88#0A#88#0A#88#0A#88#0A#88#0A#88#0A#88#0A#88#0A#88#0A#88#0A#88#0A#88#0A#88#0A#88#0A#88#0A#88#0A#88#0A#88#0A
#0A#0A#0A#0A#0A#0A#0A#0A#0A#0A#0A#0A#0A#0A#0A#0A#0A#0A#0A#0A#0A#0A#0A#0A#0A#0A#0A#0A#0A#0A#0A#0A#0A#0A#0A#0A#0A#0A#0A#0A#0A#0A#0A#0A#0A#0A#0A#0A#0A#0A#0A#0A#0A#0A#0A#0A#0A#0A#0A#0A#0A#0A#0A#0A#0A#0A#0A#0A#0A#0A#0A#0A#0A#0A#0A
#0A#88#0A#88#0A#88#0A#88#0A#88#0A#88#0A#88#0A#88#0A#88#0A#88#0A#88#0A#88#0A#88#0A#88#0A#88#0A#88#0A#88#0A#88#0A#88#0A#88#0A#88#0A#88#0A#88#0A#88#0A#88#0A#88#0A#88#0A#88#0A#88#0A#88#0A#88#0A#88#0A#88#0A#88#0A#88#0A#88#0A#88#0A
#0A#0A#0A#0A#0A#0A#0A#0A#0A#0A#0A#0A#0A#0A#0A#0A#0A#0A#0A#0A#0A#0A#0A#0A#0A#0A#0A#0A#0A#0A#0A#0A#0A#0A#0A#0A#0A#0A#0A#0A#0A#0A#0A#0A#0A#0A#0A#0A#0A#0A#0A#0A#0A#0A#0A#0A#0A#0A#0A#0A#0A#0A#0A#0A#0A#0A#0A#0A#0A#0A#0A#0A#0A#0A#0A
#0A#88#0A#88#0A#88#0A#88#0A#88#0A#88#0A#88#0A#88#0A#88#0A#88#0A#88#0A#88#0A#88#0A#88#0A#88#0A#88#0A#88#0A#88#0A#88#0A#88#0A#88#0A#88#0A#88#0A#88#0A#88#0A#88#0A#88#0A#88#0A#88#0A#88#0A#88#0A#88#0A#88#0A#88#0A#88#0A#88#0A#88#0A
#0A#0A#0A#0A#0A#0A#0A#0A#0A#0A#0A#0A#0A#0A#0A#0A#0A#0A#0A#0A#0A#0A#0A#0A#0A#0A#0A#0A#0A#0A#0A#0A#0A#0A#0A#0A#0A#0A#0A#0A#0A#0A#0A#0A#0A#0A#0A#0A#0A#0A#0A#0A#0A#0A#0A#0A#0A#0A#0A#0A#0A#0A#0A#0A#0A#0A#0A#0A#0A#0A#0A#0A#0A#0A#0A
#0A#88#0A#88#0A#88#0A#88#0A#88#0A#88#0A#88#0A#88#0A#88#0A#88#0A#88#0A#88#0A#88#0A#88#0A#88#0A#88#0A#88#0A#88#0A#88#0A#88#0A#88#0A#88#0A#88#0A#88#0A#88#0A#88#0A#88#0A#88#0A#88#0A#88#0A#88#0A#88#0A#88#0A#88#0A#88#0A#88#0A#88#0A
#0A#0A#0A#0A#0A#0A#0A#0A#0A#0A#0A#0A#0A#0A#0A#0A#0A#0A#0A#0A#0A#0A#0A#0A#0A#0A#0A#0A#0A#0A#0A#0A#0A#0A#0A#0A#0A#0A#0A#0A#0A#0A#0A#0A#0A#0A#0A#0A#0A#0A#0A#0A#0A#0A#0A#0A#0A#0A#0A#0A#0A#0A#0A#0A#0A#0A#0A#0A#0A#0A#0A#0A#0A#0A#0A
#0A#88#0A#88#0A#88#0A#88#0A#88#0A#88#0A#88#0A#88#0A#88#0A#88#0A#88#0A#88#0A#88#0A#88#0A#88#0A#88#0A#88#0A#88#0A#88#0A#88#0A#88#0A#88#0A#88#0A#88#0A#88#0A#88#0A#88#0A#88#0A#88#0A#88#0A#88#0A#88#0A#88#0A#88#0A#88#0A#88#0A#88#0A
#0A#0A#0A#0A#0A#0A#0A#0A#0A#0A#0A#0A#0A#0A#0A#0A#0A#0A#0A#0A#0A#0A#0A#0A#0A#0A#0A#0A#0A#0A#0A#0A#0A#0A#0A#0A#0A#0A#0A#0A#0A#0A#0A#0A#0A#0A#0A#0A#0A#0A#0A#0A#0A#0A#0A#0A#0A#0A#0A#0A#0A#0A#0A#0A#0A#0A#0A#0A#0A#0A#0A#0A#0A#0A#0A
#0A#88#0A#88#0A#88#0A#88#0A#88#0A#88#0A#88#0A#88#0A#88#0A#88#0A#88#0A#88#0A#88#0A#88#0A#88#0A#88#0A#88#0A#88#0A#88#0A#88#0A#88#0A#88#0A#88#0A#88#0A#88#0A#88#0A#88#0A#88#0A#88#0A#88#0A#88#0A#88#0A#88#0A#88#0A#88#0A#88#0A#88#0A
#0A#0A#0A#0A#0A#0A#0A#0A#0A#0A#0A#0A#0A#0A#0A#0A#0A#0A#0A#0A#0A#0A#0A#0A#0A#0A#0A#0A#0A#0A#0A#0A#0A#0A#0A#0A#0A#0A#0A#0A#0A#0A#0A#0A#0A#0A#0A#0A#0A#0A#0A#0A#0A#0A#0A#0A#0A#0A#0A#0A#0A#0A#0A#0A#0A#0A#0A#0A#0A#0A#0A#0A#0A#0A#0A
#0A#88#0A#88#0A#88#0A#88#0A#88#0A#88#0A#88#0A#88#0A#88#0A#88#0A#88#0A#88#0A#88#0A#88#0A#88#0A#88#0A#88#0A#88#0A#88#0A#88#0A#88#0A#88#0A#88#0A#88#0A#88#0A#88#0A#88#0A#88#0A#88#0A#88#0A#88#0A#88#0A#88#0A#88#0A#88#0A#88#0A#88#0A
#0A#0A#0A#0A#0A#0A#0A#0A#0A#0A#0A#0A#0A#0A#0A#0A#0A#0A#0A#0A#0A#0A#0A#0A#0A#0A#0A#0A#0A#0A#0A#0A#0A#0A#0A#0A#0A#0A#0A#0A#0A#0A#0A#0A#0A#0A#0A#0A#0A#0A#0A#0A#0A#0A#0A#0A#0A#0A#0A#0A#0A#0A#0A#0A#0A#0A#0A#0A#0A#0A#0A#0A#0A#0A#0A
#0A#88#0A#88#0A#88#0A#88#0A#88#0A#88#0A#88#0A#88#0A#88#0A#88#0A#88#0A#88#0A#88#0A#88#0A#88#0A#88#0A#88#0A#88#0A#88#0A#88#0A#88#0A#88#0A#88#0A#88#0A#88#0A#88#0A#88#0A#88#0A#88#0A#88#0A#88#0A#88#0A#88#0A#88#0A#88#0A#88#0A#88#0A
#0A#0A#0A#0A#0A#0A#0A#0A#0A#0A#0A#0A#0A#0A#0A#0A#0A#0A#0A#0A#0A#0A#0A#0A#0A#0A#0A#0A#0A#0A#0A#0A#0A#0A#0A#0A#0A#0A#0A#0A#0A#0A#0A#0A#0A#0A#0A#0A#0A#0A#0A#0A#0A#0A#0A#0A#0A#0A#0A#0A#0A#0A#0A#0A#0A#0A#0A#0A#0A#0A#0A#0A#0A#0A#0A
#0A#88#0A#88#0A#88#0A#88#0A#88#0A#88#0A#88#0A#88#0A#88#0A#88#0A#88#0A#88#0A#88#0A#88#0A#88#0A#88#0A#88#0A#88#0A#88#0A#88#0A#88#0A#88#0A#88#0A#88#0A#88#0A#88#0A#88#0A#88#0A#88#0A#88#0A#88#0A#88#0A#88#0A#88#0A#88#0A#88#0A#88#0A
#0A#0A#0A#0A#0A#0A#0A#0A#0A#0A#0A#0A#0A#0A#0A#0A#0A#0A#0A#0A#0A#0A#0A#0A#0A#0A#0A#0A#0A#0A#0A#0A#0A#0A#0A#0A#0A#0A#0A#0A#0A#0A#0A#0A#0A#0A#0A#0A#0A#0A#0A#0A#0A#0A#0A#0A#0A#0A#0A#0A#0A#0A#0A#0A#0A#0A#0A#0A#0A#0A#0A#0A#0A#0A#0A
#0A#88#0A#88#0A#88#0A#88#0A#88#0A#88#0A#88#0A#88#0A#88#0A#88#0A#88#0A#88#0A#88#0A#88#0A#88#0A#88#0A#88#0A#88#0A#88#0A#88#0A#88#0A#88#0A#88#0A#88#0A#88#0A#88#0A#88#0A#88#0A#88#0A#88#0A#88#0A#88#0A#88#0A#88#0A#88#0A#88#0A#88#0A
#0A#0A#0A#0A#0A#0A#0A#0A#0A#0A#0A#0A#0A#0A#0A#0A#0A#0A#0A#0A#0A#0A#0A#0A#0A#0A#0A#0A#0A#0A#0A#0A#0A#0A#0A#0A#0A#0A#0A#0A#0A#0A#0A#0A#0A#0A#0A#0A#0A#0A#0A#0A#0A#0A#0A#0A#0A#0A#0A#0A#0A#0A#0A#0A#0A#0A#0A#0A#0A#0A#0A#0A#0A#0A#0A
#0A#88#0A#88#0A#88#0A#88#0A#88#0A#88#0A#88#0A#88#0A#88#0A#88#0A#88#0A#88#0A#88#0A#88#0A#88#0A#88#0A#88#0A#88#0A#88#0A#88#0A#88#0A#88#0A#88#0A#88#0A#88#0A#88#0A#88#0A#88#0A#88#0A#88#0A#88#0A#88#0A#88#0A#88#0A#88#0A#88#0A#88#0A
#0A#0A#0A#0A#0A#0A#0A#0A#0A#0A#0A#0A#0A#0A#0A#0A#0A#0A#0A#0A#0A#0A#0A#0A#0A#0A#0A#0A#0A#0A#0A#0A#0A#0A#0A#0A#0A#0A#0A#0A#0A#0A#0A#0A#0A#0A#0A#0A#0A#0A#0A#0A#0A#0A#0A#0A#0A#0A#0A#0A#0A#0A#0A#0A#0A#0A#0A#0A#0A#0A#0A#0A#0A#0A#0A
#0A#88#0A#88#0A#88#0A#88#0A#88#0A#88#0A#88#0A#88#0A#88#0A#88#0A#88#0A#88#0A#88#0A#88#0A#88#0A#88#0A#88#0A#88#0A#88#0A#88#0A#88#0A#88#0A#88#0A#88#0A#88#0A#88#0A#88#0A#88#0A#88#0A#88#0A#88#0A#88#0A#88#0A#88#0A#88#0A#88#0A#88#0A
#0A#0A#0A#0A#0A#0A#0A#0A#0A#0A#0A#0A#0A#0A#0A#0A#0A#0A#0A#0A#0A#0A#0A#0A#0A#0A#0A#0A#0A#0A#0A#0A#0A#0A#0A#0A#0A#0A#0A#0A#0A#0A#0A#0A#0A#0A#0A#0A#0A#0A#0A#0A#0A#0A#0A#0A#0A#0A#0A#0A#0A#0A#0A#0A#0A#0A#0A#0A#0A#0A#0A#0A#0A#0A#0A
#0A#88#0A#88#0A#88#0A#88#0A#88#0A#88#0A#88#0A#88#0A#88#0A#88#0A#88#0A#88#0A#88#0A#88#0A#88#0A#88#0A#88#0A#88#0A#88#0A#88#0A#88#0A#88#0A#88#0A#88#0A#88#0A#88#0A#88#0A#88#0A#88#0A#88#0A#88#0A#88#0A#88#0A#88#0A#88#0A#88#0A#88#0A
#0A#0A#0A#0A#0A#0A#0A#0A#0A#0A#0A#0A#0A#0A#0A#0A#0A#0A#0A#0A#0A#0A#0A#0A#0A#0A#0A#0A#0A#0A#0A#0A#0A#0A#0A#0A#0A#0A#0A#0A#0A#0A#0A#0A#0A#0A#0A#0A#0A#0A#0A#0A#0A#0A#0A#0A#0A#0A#0A#0A#0A#0A#0A#0A#0A#0A#0A#0A#0A#0A#0A#0A#0A#0A#0A
#0A#88#0A#88#0A#88#0A#88#0A#88#0A#88#0A#88#0A#88#0A#88#0A#88#0A#88#0A#88#0A#88#0A#88#0A#88#0A#88#0A#88#0A#88#0A#88#0A#88#0A#88#0A#88#0A#88#0A#88#0A#88#0A#88#0A#88#0A#88#0A#88#0A#88#0A#88#0A#88#0A#88#0A#88#0A#88#0A#88#0A#88#0A
#0A#0A#0A#0A#0A#0A#0A#0A#0A#0A#0A#0A#0A#0A#0A#0A#0A#0A#0A#0A#0A#0A#0A#0A#0A#0A#0A#0A#0A#0A#0A#0A#0A#0A#0A#0A#0A#0A#0A#0A#0A#0A#0A#0A#0A#0A#0A#0A#0A#0A#0A#0A#0A#0A#0A#0A#0A#0A#0A#0A#0A#0A#0A#0A#0A#0A#0A#0A#0A#0A#0A#0A#0A#0A#0A
collision:
000000000000000000000000000000000000000000000000000000000000000000000000000
010101010101010101010101010101010101010101010101010101010101010101010101010
0000a00000000000000000000000000000000000000000000000000000000000000000b0000
0101a10101010101010101010101010101010101010101010101010101010101010101b1010
00aaAaa0000000000000000000000000000000000000000000000000000000000000bbBbb00
0101a10101010101010101010101010101010101010101010101010101010101010101b1010
0000a00000000000000000000000000000000000000000000000000000000000000000b0000
010101010101010101010101010101010101010101010101010101010101010101010101010
000000000000000000000000000000000000000000000000000000000000000000000000000
010101010101010101010101010101010101010101010101010101010101010101010101010
000000000000000000000000000000000000000000000000000000000000000000000000000
010101010101010101010101010101010101010101010101010101010101010101010101010
000000000000000000000000000000000000000000000000000000000000000000000000000
010101010101010101010101010101010101010101010101010101010101010101010101010
000000000000000000000000000000000000000000000000000000000000000000000000000
010101010101010101010101010101010101010101010101010101010101010101010101010
000000000000000000000000000000000000000000000000000000000000000000000000000
010101010101010101010101010101010101010101010101010101010101010101010101010
000000000000000000000000000000000000000000000000000000000000000000000000000
010101010101010101010101010101010101010101010101010101010101010101010101010
000000000000000000000000000000000000000000000000000000000000000000000000000
010101010101010101010101010101010101010101010101010101010101010101010101010
0000d00000000000000000000000000000000000000000000000000000000000000000c0000
0101d10101010101010101010101010101010101010101010101010101010101010101c1010
00ddDdd0000000000000000000000000000000000000000000000000000000000000ccCcc00
0101d10101010101010101010101010101010101010101010101010101010101010101c1010
0000d00000000000000000000000000000000000000000000000000000000000000000c0000
010101010101010101010101010101010101010101010101010101010101010101010101010
000000000000000000000000000000000000000000000000000000000000000000000000000