79 37
start:
#88#88#88#88#88#88#88#88#88#88#88#88#88#88#88#88#88#88#88#88#88#88#88#88#88#88#88#88#88#88#88#88#88#88#88#88#88#88#88#88#88#88#88#88#88#88#88#88#88#88#88#88#88#88#88#88#88#88#88#88#88#88#88#88#88#88#88#88#88#88#88#88#88#88#88#88#88#88#88
#88#88#88#88#88#88#88#88#88#88#88#88#88#88#88#88#88#88#88#88#88#88#88#88#88#88#88#88#88#88#88#88#88#88#88#88#88#88#88#88#88#88#88#88#88#88#88#88#88#88#88#88#88#88#88#88#88#88#88#88#88#88#88#88#88#88#88#88#88#88#88#88#88#88#88#88#88#88#88
#88#88#88#88#88#88#88#88#88#88#88#88#CC#CC#CC#CC#88#88#88#CC#CC#CC#88#88#CC#88#88#88#88#88#88#88#CC#88#CC#CC#CC#CC#88#88#CC#CC#CC#CC#88#CC#CC#CC#88#88#88#CC#88#88#88#88#88#88#88#CC#88#88#88#88#CC#CC#88#88#88#88#CC#88#88#88#88#88#88#CC#88
#88#88#88#88#88#88#88#88#88#88#88#88#CC#88#88#88#CC#88#CC#88#88#88#CC#88#CC#CC#88#88#88#88#88#CC#CC#88#CC#88#88#88#CC#88#CC#88#88#88#88#CC#88#88#CC#88#88#CC#CC#88#88#88#88#88#CC#CC#88#88#88#88#CC#CC#88#88#88#88#CC#CC#88#88#88#88#88#CC#88
#88#88#88#88#88#88#88#88#88#88#88#88#CC#88#88#88#CC#88#CC#88#88#88#CC#88#CC#88#CC#88#88#88#CC#88#CC#88#CC#88#88#88#CC#88#CC#88#88#88#88#CC#88#88#CC#88#88#CC#88#CC#88#88#88#CC#88#CC#88#88#88#CC#88#88#CC#88#88#88#CC#88#CC#88#88#88#88#CC#88
#88#88#88#88#88#88#88#88#88#88#88#88#CC#CC#CC#CC#88#88#CC#88#88#88#CC#88#CC#88#88#CC#88#CC#88#88#CC#88#CC#CC#CC#CC#88#88#CC#CC#CC#88#88#CC#CC#CC#88#88#88#CC#88#88#CC#88#CC#88#88#CC#88#88#88#CC#88#88#CC#88#88#88#CC#88#88#CC#88#88#88#CC#88
#88#88#88#88#88#88#88#88#88#88#88#88#CC#88#88#88#CC#88#CC#88#88#88#CC#88#CC#88#88#88#CC#88#88#88#CC#88#CC#88#88#88#CC#88#CC#88#88#88#88#CC#CC#88#88#88#88#CC#88#88#88#CC#88#88#88#CC#88#88#CC#88#88#88#88#CC#88#88#CC#88#88#88#CC#88#88#CC#88
#88#88#88#88#88#88#88#88#88#88#88#88#CC#88#88#88#CC#88#CC#88#88#88#CC#88#CC#88#88#88#88#88#88#88#CC#88#CC#88#88#88#CC#88#CC#88#88#88#88#CC#88#CC#88#88#88#CC#88#88#88#88#88#88#88#CC#88#88#CC#CC#CC#CC#CC#CC#88#88#CC#88#88#88#88#CC#88#CC#88
#88#88#88#88#88#88#88#88#88#88#88#88#CC#88#88#88#CC#88#CC#88#88#88#CC#88#CC#88#88#88#88#88#88#88#CC#88#CC#88#88#88#CC#88#CC#88#88#88#88#CC#88#88#CC#88#88#CC#88#88#88#88#88#88#88#CC#88#CC#88#88#88#88#88#88#CC#88#CC#88#88#88#88#88#CC#CC#88
#88#88#88#88#88#88#88#88#88#88#88#88#CC#CC#CC#CC#88#88#88#CC#CC#CC#88#88#CC#88#88#88#88#88#88#88#CC#88#CC#CC#CC#CC#88#88#CC#CC#CC#CC#88#CC#88#88#88#CC#88#CC#88#88#88#88#88#88#88#CC#88#CC#88#88#88#88#88#88#CC#88#CC#88#88#88#88#88#88#CC#88
#88#88#88#88#88#88#88#88#88#88#88#88#88#88#88#88#88#88#88#88#88#88#88#88#88#88#88#88#88#88#88#88#88#88#88#88#88#88#88#88#88#88#88#88#88#88#88#88#88#88#88#88#88#88#88#88#88#88#88#88#88#88#88#88#88#88#88#88#88#88#88#88#88#88#88#88#88#88#88
#88#88#88#88#88#88#88#88#88#88#88#88#88#88#88#88#88#88#88#88#88#88#88#88#88#88#88#88#88#88#88#88#88#88#88#88#88#88#88#88#88#88#88#88#88#88#88#88#88#88#88#88#88#88#88#88#88#88#88#88#88#88#88#88#88#88#88#88#88#88#88#88#88#88#88#88#88#88#88
#88#88#88#88#88#88#88#88#88#88#88#88#88#88#88#88#88#88#88#88#88#88#88#88#88#88#88#88#88#88#88#88#88#88#88#88#88#88#88#88#88#88#88#88#88#88#88#88#88#88#88#88#88#88#88#88#88#88#88#88#88#88#88#88#88#88#88#88#88#88#88#88#88#88#88#88#88#88#88
#88#88#88#88#88#88#88#88#88#88#88#88#88#88#88#88#88#88#88#88#88#88#88#88#88#88#88#88#88#88#88#88#88#88#88#88#88#88#88#88#88#88#88#88#88#88#88#88#88#88#88#88#88#88#88#88#88#88#88#88#88#88#88#88#88#88#88#88#88#88#88#88#88#88#88#88#88#88#88
#88#88#88#88#88#88#88#88#88#88#88#88#88#88#88#88#88#88#88#88#88#88#88#88#88#88#88#88#88#88#88#88#88#88#88#88#88#88#88#88#88#88#88#88#88#88#88#88#88#88#88#88#88#88#88#88#88#88#88#88#88#88#88#88#88#88#88#88#88#88#88#88#88#88#88#88#88#88#88
#88#88#88#88#88#88#88#88#88#88#88#88#88#88#88#88#88#88#88#88#88#88#88#88#88#88#88#88#88#88#88#88#88#88#88#88#88#88#88#88#88#88#88#88#88#88#88#88#88#88#88#88#88#88#88#88#88#88#88#88#88#88#88#88#88#88#88#88#88#88#88#88#88#88#88#88#88#88#88
#88#88#88#88#88#88#88#88#88#88#88#88#88#88#88#88#88#88#88#88#88#88#88#88#88#88#88#88#88#88#88#88#88#88#88#88#88#88#88#88#88#88#88#88#88#88#88#88#88#88#88#88#88#88#88#88#88#88#88#88#88#88#88#88#88#88#88#88#88#88#88#88#88#88#88#88#88#88#88
#88#88#88#88#88#88#88#88#88#88#88#88#88#88#88#88#88#88#88#88#88#88#88#88#88#88#88#88#88#88#88#88#88#88#88#88#88#88#88#88#88#88#88#88#88#88#88#88#88#88#88#88#88#88#88#88#88#88#88#88#88#88#88#88#88#88#88#88#88#88#88#88#88#88#88#88#88#88#88
#88#88#88#88#88#88#88#88#88#88#88#88#88#88#88#88#88#88#88#88#88#88#88#88#88#88#88#88#88#88#88#88#88#88#88#88#88#88#88#88#88#88#88#88#88#88#88#88#88#88#88#88#88#88#88#88#88#88#88#88#88#88#88#88#88#88#88#88#88#88#88#88#88#88#88#88#88#88#88
#88#88#88#88#88#88#88#88#88#88#88#88#88#88#88#88#88#88#88#88#88#88#88#88#88#88#88#88#88#88#88#88#88#88#88#88#88#88#88#88#88#88#88#88#88#88#88#88#88#88#88#88#88#88#88#88#88#88#88#88#88#88#88#88#88#88#88#88#88#88#88#88#88#88#88#88#88#88#88
#88#88#88#88#88#88#88#88#88#88#88#88#88#88#88#88#88#88#88#88#88#88#88#88#88#88#88#88#88#88#88#88#88#88#88#88#88#88#88#88#88#88#88#88#88#88#88#88#88#88#88#88#88#88#88#88#88#88#88#88#88#88#88#88#88#88#88#88#88#88#88#88#88#88#88#88#88#88#88
#88#88#88#88#88#88#88#88#88#88#88#88#88#88#88#88#88#88#88#88#88#88#88#88#88#88#88#88#88#88#88#88#88#88#88#88#88#88#88#88#88#88#88#88#88#88#88#88#88#88#88#88#88#88#88#88#88#88#88#88#88#88#88#88#88#88#88#88#88#88#88#88#88#88#88#88#88#88#88
#88#88#88#88#88#88#88#88#88#88#88#88#88#88#88#88#88#88#88#88#88#88#88#88#88#88#88#88#88#88#88#88#88#88#88#88#88#88#88#88#88#88#88#88#88#88#88#88#88#88#88#88#88#88#88#88#88#88#88#88#88#88#88#88#88#88#88#88#88#88#88#88#88#88#88#88#88#88#88
#88#88#88#88#88#88#88#88#88#88#88#88#88#88#88#88#88#88#88#88#88#88#88#88#88#88#88#88#88#88#88#88#88#88#88#88#88#88#88#88#88#88#88#88#88#88#88#88#88#88#88#88#88#88#88#88#88#88#88#88#88#88#88#88#88#88#88#88#88#88#88#88#88#EE#EE#88#88#88#88
#88#88#88#88#88#88#88#88#88#88#88#88#88#88#88#88#88#88#88#88#88#88#88#88#88#88#88#88#88#88#88#88#88#88#88#88#88#88#88#88#88#88#88#88#88#88#88#88#88#88#88#88#88#88#88#88#88#88#88#88#88#88#88#88#88#88#88#88#88#88#88#88#88#88#88#EE#88#88#88
#88#88#88#88#88#88#88#88#88#88#88#88#88#88#88#88#88#88#88#88#88#88#88#88#88#88#88#88#88#88#88#88#88#88#88#88#88#88#88#88#88#88#88#88#88#88#88#88#88#88#88#88#88#88#88#88#88#88#88#88#88#88#88#88#88#88#88#88#88#88#88#88#88#88#88#88#EE#88#88
#88#88#88#88#88#88#88#88#88#88#88#88#88#88#88#88#88#88#88#88#88#88#88#88#88#88#88#88#88#88#88#88#88#88#88#88#88#88#88#88#88#88#88#88#88#88#88#88#88#88#88#88#88#88#88#88#88#88#88#88#88#88#88#88#88#88#88#88#88#88#88#88#88#88#88#88#88#EE#88
#88#88#88#88#88#88#88#88#88#88#88#88#88#88#88#88#88#88#88#88#88#88#88#88#88#88#88#88#88#88#88#88#88#88#88#88#88#88#88#88#88#88#88#88#88#88#88#88#88#88#88#88#88#88#88#88#88#88#88#88#88#88#88#88#88#88#88#88#88#88#88#88#88#88#88#88#88#EE#88
#88#88#88#88#88#88#88#88#88#88#88#88#88#88#88#88#88#88#88#88#88#88#88#88#88#88#88#88#88#88#88#88#88#88#88#88#88#88#88#88#88#88#88#88#88#88#88#88#88#88#88#88#88#88#88#88#88#88#88#88#88#88#88#88#88#88#88#88#88#88#88#88#88#88#88#00#00#00#00
#88#88#88#88#88#88#88#88#88#88#88#88#88#88#88#88#88#88#88#88#88#88#88#88#88#88#88#88#88#88#88#88#88#88#88#88#88#88#88#88#88#88#88#88#88#88#88#88#88#88#88#88#88#88#88#88#88#88#88#88#88#88#88#88#88#88#88#88#88#88#00#00#00#00#00#00#00#00#00
#88#88#88#88#88#88#88#88#88#88#88#88#88#88#88#88#88#88#88#88#88#88#88#88#88#88#88#88#88#88#88#88#88#88#88#88#88#88#88#88#88#88#88#88#88#88#88#88#88#88#88#88#88#88#88#88#88#88#88#88#88#88#88#88#88#88#88#88#00#00#00#00#00#00#00#00#00#00#00
#88#88#88#88#88#88#88#88#88#88#88#88#88#88#88#88#88#88#88#88#88#88#88#88#88#88#88#88#88#88#88#88#88#88#88#88#88#88#88#88#88#88#88#88#88#88#88#88#88#88#88#88#88#88#88#88#88#88#88#88#88#88#88#88#88#88#88#00#00#00#00#00#00#00#00#00#00#00#00
#88#88#88#88#88#88#88#88#88#88#88#88#88#88#88#88#88#88#88#88#88#88#88#88#88#88#88#88#88#88#88#88#88#88#88#88#88#88#88#88#88#88#88#88#88#88#88#88#88#88#88#88#88#88#88#88#88#88#88#88#88#88#88#88#88#88#00#00#00#00#00#00#00#00#00#00#00#00#00
#88#88#88#88#88#88#88#88#88#88#88#88#88#88#88#88#88#88#88#88#88#88#88#88#88#88#88#88#88#88#88#88#88#88#88#88#88#88#88#88#88#88#88#88#88#88#88#88#88#88#88#88#88#88#88#88#88#88#88#88#88#88#88#88#88#88#00#00#00#00#00#00#00#00#00#00#00#00#00
#88#88#88#88#88#88#88#88#88#88#88#88#88#88#88#88#88#88#88#88#88#88#88#88#88#88#88#88#88#88#88#88#88#88#88#88#88#88#88#88#88#88#88#88#88#88#88#88#88#88#88#88#88#88#88#88#88#88#88#88#88#88#88#88#88#88#00#00#00#00#00#00#00#00#00#00#00#00#00
#88#88#88#88#88#88#88#88#88#88#88#88#88#88#88#88#88#88#88#88#88#88#88#88#88#88#88#88#88#88#88#88#88#88#88#88#88#88#88#88#88#88#88#88#88#88#88#88#88#88#88#88#88#88#88#88#88#88#88#88#88#88#88#88#88#88#88#00#00#00#00#00#00#00#00#00#00#00#00
#88#88#88#88#88#88#88#88#88#88#88#88#88#88#88#88#88#88#88#88#88#88#88#88#88#88#88#88#88#88#88#88#88#88#88#88#88#88#88#88#88#88#88#88#88#88#88#88#88#88#88#88#88#88#88#88#88#88#88#88#88#88#88#88#88#88#88#88#00#00#00#00#00#00#00#00#00#00#00